########################################################################################################################################################################################################
#                           #                                                                                                                                                                          #
#                           #                                                                                                                                                                          #
#                           #                                                                                              #                                                                           #
#                           #                                                                                              #                                                                           #
#              E            #                                                                                              #                                                                           #
#                           #                                                                                              #                                                                           #
#                           #                                                                                              #                                                                           #
#                           #                                                                                              #                                                                           #
#                           #                                                                                              #                                                                           #
#                           #                                                                                              #                                                                           #
#                           #                                                                                              #                                                                           #
#                           #                                                                                              #                                                                           #
#                                                                                                                          #                                                                           #
#                                                                                                                          #                                                                           #
#                                                                                                                          #        E                                                                  #
#                                                                                                                          #                                                                           #
#                                                                                                                          #                                                                           #
#                                                                                                 ###############################################################                       ################
#                                                                                                                                                                                                      #
########################################                                                                                                                                                               #
#                                                                                                                                                                                                      #
#                                                                                                                                                                                                      #
#                                                                                                                                                                                                      #
#                                                                                                                                                                                                      #
#                                                                                                                                                                                                      #
#                                                                                                                                                                                                      #
#                                                                                                                                                                                                      #
                                                                                              A


                                                              ###############################################################
S




#                                                                                                                                                                                                      #
#                                                                                                                                                                                                      #
#                                                                                                                                                                                                      #
#                                                                                                                                                                                                      #
#                                                                                                                                                                                                      #
#                                                                                                                                                                                                      #
#                                                                                                                                                                                                      #
#                                                                                                                                                                                                      #
#                                                                                                                                                                                                      #
#                                                                                                                                                                                                      #
#                                                                                                                                                                                                      #
#                                                                                                                                                                                                      #
#                                                                                                                                                                                                      #
#                                                                                                                                                                                                      #
#                                                                                                                                                                                                      #
################################################################                                                                                                   #                                   #
#                                                                                                                                                                  #                                   #
#                                                                                                                                                                  #                                   #
#                                                                                                                                                                  #                                   #
#                                                                                                                                                                  #                                   #
#                                                                                                                                                                  #                                   #
#                                                                                                                                                                  #                                   #
#                                                                                                                                                                  #                                   #
#                                                                                                                                                                  #                                   #
#                                                                                                                                                                  #                                   #
#                                                                                                                                                                  #                                   #
#                                                                                                                                                                  #                                   #
#                                                                                                                                                                  #                                   #
#                                                                                                                                                                  #                                   #
#                                                                                                                                                                  #                                   #
#                                                                                                                                                                  #                                   #
#                                                                                                                                                                  #                                   #
########################################################################################################################################################################################################
